1 2 3 4 5 6 7 8 9 0 2 3 4 5 6 1
1 2 3 4 5 6 7 8 9 0 2 8 4 5 6 1
1 2 3 4 5 6 7 8 9 0 2 3 4 7 6 1
1 2 3 4 5 6 7 8 9 0 2 3 4 5 6 1
1 2 3 4 5 6 7 8 9 0 2 3 4 5 6 1
1 2 3 4 5 6 7 8 9 0 2 3 4 5 6 1
1 2 3 4 5 6 7 8 9 0 2 3 4 5 6 1
1 2 3 4 5 6 7 8 9 0 2 3 4 5 6 1
1 2 3 4 5 6 7 8 9 0 2 3 4 5 6 1
1 2 3 4 5 6 7 8 9 0 2 3 4 5 6 1
1 2 3 4 5 6 7 8 9 0 2 3 4 5 6 1
1 2 3 4 5 6 7 8 9 0 2 3 4 5 6 1
1 2 3 4 5 6 7 8 9 0 2 3 4 5 6 1
1 2 3 4 5 6 7 8 9 0 2 3 4 5 6 1
1 2 3 4 5 6 7 8 9 0 2 3 4 5 6 1
1 2 3 4 5 6 7 8 9 0 2 3 4 5 6 1